--------------------------------------------------------------------------------------------------------------------------------------------------------------------------------------------------------
--------------------------------------------------------------------------------------------------------------------------------------------------------------------------------------------------------
--------------------------------------------------------------------------------------------------------------------------------------------------------------------------------------------------------
--------------------------------------------------------------------------------------------------------------------------------------------------------------------------------------------------------
--------------------------------------------------------------------------------------------------------------------------------------------------------------------------------------------------------
--------------------------------------------------------------------------------------------------------------------------------------------------------------------------------------------------------
--------------------------------------------------------------------------------------------------------------------------------------------------------------------------------------------------------
-------------------------------------------------------------------------------------------------------------------------------------------------------------------------------------------------------v
-------------------------------------------------------------------------------------------------------------------------------------------------------------------------------------------------------f
----------ooo----------------o--------------------------------------------------------?----B-B----B-B---------------------B-------?-----------ooo--------ooo------------------------------?oo---ooo----f
M------------------------BB----------------ooo----------?-?--B-B---------------------------------o---------------------------------M-?-?---------?----------B-B----M----------?------------------------f
-------T---ooo----------T---T-------------------?-?----------?------------------------------------------------M-------o----------------oo--X---------------?-?---------------ooo-T---------------------f
-------|----?-X---------|---|---X----X------------------------------ooo----ooo--------?-------------T------------------B------------------XXX--?-----------M---------------------|-B-------------------f
------o|-----XXX--------|--o|--XXX--XXX---------X-X------------------X----------T--------X----------|-------------------------------X----XXXXX---------X---------------T--ooo----|-----------X-------T-f
m------|----XXXXX-------|E--|-XXXXXXXXXX-------XXXXXT---------------XXX-----E---|-------XXX---E---T-|--E---------------------------XXX--XXXXXXX-------XXX---E------E---|---------|----------XXT--E---|-X
XXXXXXXXXXXXXXXXXXXXXXXXXXXXXXXXXXXXXXXXXXXXXXXXXXXXXXXXXXXXXXXXXXXXXXXXXXXXXXXXXXXXXXXXXXXXXXXXXXXXXXXXXXXXXXXXXXXXXXXXXXXXXXXXXXXXXXXXXXXXXXXXXXXXXXXXXXXXXXXXXXXXXXXXXXXXXXXXXXXXXXXXXXXXXXXXXXXXXXXX
