--------------------------------------------------------------------------------------------------------------------------------------------------------------------------------------------------------
--------------------------------------------------------------------------------------------------------------------------------------------------------------------------------------------------------
--------------------------------------------------------------------------------------------------------------------------------------------------------------------------------------------------------
--------------------------------------------------------------------------------------------------------------------------------------------------------------------------------------------------------
--------------------------------------------------------------------------------------------------------------------------------------------------------------------------------------------------------
--------------------------------------------------------------------------------------------------------------------------------------------------------------------------------------------------------
--------------------------------------------------------------------------------------------------------------------------------------------------------------------------------------------------------
-------------------------------------------------------------------------------------------------------------------------------------------------------------------------------------------------------v
-----------------------M?B?-B--------------------------------X------------------------------???---------------?-------------------BB----------X-----------o----B----------------------X----------------f
------------------------------X---------------------------------------------------------------------------------------------------X----??B?------------------------------------------------------------f
--------------BB-BB?------?---------------------o--------------BB?BBB?-----------------o-----------M-?B?B---??------------------------o-----------------------o--------------------B---o--X------------f
------------------------?--------T---------------------------T---------o-------X--X-------T---X-------------X-------------------------------T------------X------------BB-------------------o--T--T-----f
----------T-------X??B----T------|------------T--------------|o------------------XX----T--|---XX----?------T-------T------------------T-----|-------------------B------------T--------T----??-|--|----Tf
------T---|---------------|-o---o|------------|----T----o----|---T--------oX----XXX----|--|---XXX----------|-------|------------------|-----|------o------------T------------|--------|-------|--|----|f
m---E-|---|-----------E---|------|---E--------|----|------E--|---|-------------XXXX----|-E|---XXXX---------|-------|----------E-------|-----|-------------------|---E------E-|------X-|-------|--|---E|X
XXXXXXXXXXXXXXXXXXXXXXXXXXXXXXXXXXXXXXXXXXXXXXXXXXXXXXXXXXXXXXXXXXXXXXXXXXXXXXXXXXXXXXXXXXXXXXXXXXXXXXXXXXXXXXXXXXXXXXXXXXXXXXXXXXXXXXXXXXXXXXXXXXXXXXXXXXXXXXXXXXXXXXXXXXXXXXXXXXXXXXXXXXXXXXXXXXXXXXXX
