--------------------------------------------------------------------------------------------------------------------------------------------------------------------------------------------------------
--------------------------------------------------------------------------------------------------------------------------------------------------------------------------------------------------------
--------------------------------------------------------------------------------------------------------------------------------------------------------------------------------------------------------
--------------------------------------------------------------------------------------------------------------------------------------------------------------------------------------------------------
--------------------------------------------------------------------------------------------------------------------------------------------------------------------------------------------------------
--------------------------------------------------------------------------------------------------------------------------------------------------------------------------------------------------------
--------------------------------------------------------------------------------------------------------------------------------------------------------------------------------------------------------
-------------------------------------------------------------------------------------------------------------------------------------------------------------------------------------------------------v
-----------------------MB??-?--------------------------------X------------------------------???---------------B-------------------?B----------X-----------oB--------------------------X----------------f
------------------------------X------------------------------B------------------------X------------------------------------------------?BB?------------------------------------------------------------f
--------------BBBBB?------?------------------------------------BB?BBBB-----------------o-----------B-?B?B---??-------------------------o----------------------o------o-------------B---o--X------------f
------------------------?--------T---------------------------T---------o-o-----X--X-------T---X-------------X-------------------------------T------------X------------BB-------------------o--T--T-----f
----------T-------X???----To-----|------------T--------------|-------------------XX----To-|---XX----?------T-------T------------------T-----|-------------------B------------T--------T----??-|--|----Tf
------T---|---------------|------|------------|----T---------|---T--------oX----XXX----|--|---XXX--o-------|-------|------------------|-----|------o---o--------T------------|--------|-------|--|----|f
m----E|---|-----------E---|------|---E--------|----|------E--|---|-------------XXXX----|-E|---XXXX---------|-------|----------E-------|-----|-------------------|----------E-|------X-|-------|--|----|X
XXXXXXXXXXXXXXXXXXXXXXXXXXXXXXXXXXXXXXXXXXXXXXXXXXXXXXXXXXXXXXXXXXXXXXXXXXXXXXXXXXXXXXXXXXXXXXXXXXXXXXXXXXXXXXXXXXXXXXXXXXXXXXXXXXXXXXXXXXXXXXXXXXXXXXXXXXXXXXXXXXXXXXXXXXXXXXXXXXXXXXXXXXXXXXXXXXXXXXXX
