--------------------------------------------------------------------------------------------------------------------------------------------------------------------------------------------------------
--------------------------------------------------------------------------------------------------------------------------------------------------------------------------------------------------------
--------------------------------------------------------------------------------------------------------------------------------------------------------------------------------------------------------
--------------------------------------------------------------------------------------------------------------------------------------------------------------------------------------------------------
--------------------------------------------------------------------------------------------------------------------------------------------------------------------------------------------------------
--------------------------------------------------------------------------------------------------------------------------------------------------------------------------------------------------------
--------------------------------------------------------------------------------------------------------------------------------------------------------------------------------------------------------
-------------------------------------------------------------------------------------------------------------------------------------------------------------------------------------------------------v
-----------------------M?B?-?--------------------------------X------------------------------B??---------------?-------------------BB----------X-----------o---------------------------X----------------f
------------------------------X----------B-------------------B-------------------------------------------------------------------------??BB--------------------------------B---------------------------f
--------------BB?BB?------?------------------------------------BB?BBB?--o--------------o-----------M-?B?B---??-------------------o----------------------------o--------------------B---o--X------------f
--------------------o---?--------T---------------------------T---------o-------X--X-----o-T---X-------------X-------------------------------T------------X------------BB-----------------o-o--T--T-----f
----------T-o-----X??B----T------|------------T--------------|-------------------XX----T--|---XX----B--o---T-----o-T------------------T--o--|-------------------B------------T--------T----??-|--|----Tf
------T---|---------------|------|------------|----T---------|---T--------oX----XXX----|--|---XXX----------|-------|------------------|-----|-------------------T------------|--------|-------|--|----|f
m-E---|---|-----------E---|------|---E--------|----|------E--|---|-------------XXXX----|-E|---XXXX---------|-------|----------E-------|-----|-------------------|----------E-|------X-|-------|--|---E|X
XXXXXXXXXXXXXXXXXXXXXXXXXXXXXXXXXXXXXXXXXXXXXXXXXXXXXXXXXXXXXXXXXXXXXXXXXXXXXXXXXXXXXXXXXXXXXXXXXXXXXXXXXXXXXXXXXXXXXXXXXXXXXXXXXXXXXXXXXXXXXXXXXXXXXXXXXXXXXXXXXXXXXXXXXXXXXXXXXXXXXXXXXXXXXXXXXXXXXXXX
