
--------------------------------------------------------------------------------------------------------------------------------------------------------------------------------------------------------
--------------------------------------------------------------------------------------------------------------------------------------------------------------------------------------------------------
--------------------------------------------------------------------------------------------------------------------------------------------------------------------------------------------------------
--------------------------------------------------------------------------------------------------------------------------------------------------------------------------------------------------------
--------------------------------------------------------------------------------------------------------------------------------------------------------------------------------------------------------
--------------------------------------------------------------------------------------------------------------------------------------------------------------------------------------------------------
--------------------------------------------------------------------------------------------------------------------------------------------------------------------------------------------------------
-------------------------------------------------------------------------------------------------------------------------------------------------------------------------------------------------------v
-----------------------M???-?--------------------------------X------------------------------???---------------?-------------------B?----------X-----------o---------------------------X----------------f
------------------------------X------------------------------B-------------------------------------------------------------------------?BB?------------------------------------------------------------f
--------------??BBB?--o---?--------------------------------o---BBB?BB?-----------------o------o----M-???B---B?------------------------------------------------o--------------------B---o--X------------f
--------------------o---?--------T---------------------------T---------o-------X--X-------T---X-------------X---------------------------o---T--o---------X------------BBo------------------o--T--T-----f
----------T-------X??B----T------|------------T--------------|-------------------XX----T--|---XX----?------T-------T------------------T-----|-------------------B------------T--------T----??-|--|----Tf
------T---|---------------|------|------------|----T---------|---T--------oX--o-XXX----|--|---XXX----------|-----o-|------------------|-----|------o---------o--T------------|---o----|-------|--|----|f
m-E---|---|-----------E---|------|---E--------|----|------E--|---|-------------XXXX----|-E|---XXXX---------|-------|----------E-------|-----|-------------------|----------E-|------X-|-------|--|---E|X
XXXXXXXXXXXXXXXXXXXXXXXXXXXXXXXXXXXXXXXXXXXXXXXXXXXXXXXXXXXXXXXXXXXXXXXXXXXXXXXXXXXXXXXXXXXXXXXXXXXXXXXXXXXXXXXXXXXXXXXXXXXXXXXXXXXXXXXXXXXXXXXXXXXXXXXXXXXXXXXXXXXXXXXXXXXXXXXXXXXXXXXXXXXXXXXXXXXXXXXX
