--------------------------------------------------------------------------------------------------------------------------------------------------------------------------------------------------------
--------------------------------------------------------------------------------------------------------------------------------------------------------------------------------------------------------
--------------------------------------------------------------------------------------------------------------------------------------------------------------------------------------------------------
--------------------------------------------------------------------------------------------------------------------------------------------------------------------------------------------------------
--------------------------------------------------------------------------------------------------------------------------------------------------------------------------------------------------------
--------------------------------------------------------------------------------------------------------------------------------------------------------------------------------------------------------
--------------------?-?-?-?--M-M-----------------------------------------------------ooo-B---------------------------------------M-M-----------------------?--B-B----------?-?--------------------------
--ooo-----------?-?-----?--------------M-------------------------------------------------------------?-?---?-?-----------------------------------------------------------------------------------------v
-----------------ooo------------B-B----B-B------ooo----?-?------M--B?-??-----?-ooo------------B--ooo----------M-M-?-?-----?-??-?---------------------B--?-?------------------------------------B-B-----f
-------------------------------------------B-B--B----------------------B----------?--------------?---------------------------B-------------------------------ooo--B-B----B-B-----------ooo-------M-----f
-M------------------M-M------------B-B----------------B-----?-?-------------------M-M------------------------B--------------B------------B-B----B---------oooM-M----------------------------------B-BM-f
-?-?----BB-B---M-M----------M---------------------M-M--B-----B-B--------------ooo---------ooo-------------B-B----------------------B-B--------M-M-B-B------------?----ooo----------------------------B-f
--------M-------?-?--------T-----------------------?-?--M-M-----ooo-?-----------------------?-?------X----------ooo-----------B--------ooo-X---B----------------B-B--?---------------------------------f
---------------------X-----|---T-----------------------T--------------------------------------------XXX------------ooo--------------------XXX----------------X-----------------------------------------f
m-------E-----E-----XXX----|---|----------E----E----T--|---E---------------------------------------XXXXX---------------------------------XXXXX---E----------XXX---------T---E-------E--------T---------X
XXXXXXXXXXXXXXXXXXXXXXXXXXX|XXX|XXXXXXXXXXXXXXXXXXXX|XX|XXXXXXXXXXXXXXXXXXXXXXXXXXXXXXXXXXXXXXXXXXXXXXXXXXXXXXXXXXXXXXXXXXXXXXXXXXXXXXXXXXXXXXXXXXXXXXXXXXXXXXXXXXXXXXXX|XXXXXXXXXXXXXXXXXXXX|XXXXXXXXXX
