--------------------------------------------------------------------------------------------------------------------------------------------------------------------------------------------------------
--------------------------------------------------------------------------------------------------------------------------------------------------------------------------------------------------------
--------------------------------------------------------------------------------------------------------------------------------------------------------------------------------------------------------
--------------------------------------------------------------------------------------------------------------------------------------------------------------------------------------------------------
--------------------------------------------------------------------------------------------------------------------------------------------------------------------------------------------------------
--------------------------------------------------------------------------------------------------------------------------------------------------------------------------------------------------------
------?-?-----------------------------------------?B-B-----------------?-?-----------?----------?---------------------------------------------------------------------?-?-------------------------------
------------------------B-------------------------ooo------------------------------------------------B-B-B---------?-?----------ooo-------------------?-?---------?-?----?-?-----ooo----M--------------v
------------------------?-?------------------M-M----------------M-M-----------------------------------ooo-------------------------------?-?----------ooo---------------------------------------?-?-----f
------Mooo--B-B-----------------------B--------------------------------------------------?-?-----------?-?----B-B------------------------------ooo-M--------------------------BM-M--------?-?----------f
---------------B-B---------------------ooo------------?-?------------------B-B-----B------MMM---X--X---B-B--------------M-M-------?--------B-----------------------------------------------------------f
----------------------------------------M-B----------------B-BB-BB-B-------Mooo-X-X-------------XXX---------M-M--------?-?M-M-----------------------------ooo-B-B-------ooo-------------B-Boo----------f
---------?-??-?------B------------B-B----------------------?-?----------------B-XX------------T-XXXooB-------------------XX----------B-B-ooo?-M-M--------------------------B-B------M-M-----------ooo--f
-oo--------------------------ooo----------------------------------------------T-XXX-----------|-XXXX---------------------XXooo----ooo------------------------------------------------------------------f
m-------E------E----------E---------------E------------------------------E----|XXXXX----------|XXXXXX---E---------------XXXX--------T--------------------E-----------------E--------E------E------------
XXXXXXXXXXXXXXXXXXXXXXXXXXXXXXXXXXXXXXXXXXXXXXXXXXXXXXXXXXXXXXXXXXXXXXXXXXXXXX|XXXXXXXXXXXXXXX|XXXXXXXXXXXXXXXXXXXXXXXXXXXXXXXXXXXXX|XXXXXXXXXXXXXXXXXXXXXXXXXXXXXXXXXXXXXXXXXXXXXXXXXXXXXXXXXXXXXXXXXXX
