--------------------------------------------------------------------------------------------------------------------------------------------------------------------------------------------------------
--------------------------------------------------------------------------------------------------------------------------------------------------------------------------------------------------------
--------------------------------------------------------------------------------------------------------------------------------------------------------------------------------------------------------
--------------------------------------------------------------------------------------------------------------------------------------------------------------------------------------------------------
--------------------------------------------------------------------------------------------------------------------------------------------------------------------------------------------------------
--------------------------------------------------------------------------------------------------------------------------------------------------------------------------------------------------------
--------?-------------------------B-B---------MoM-?--------------------?-?--------------------B-?--B-B------B-B-----------------------------------------------------------------------------------------
----------------------M-M------------B-B----------ooo---------M---B-B--------------------------------B-B-B---M------B-B-------ooooo-ooo------------B--?-?------------M-M-?-?-?---ooo-------------------v
------------------------?-?------------------M-M----------------M-M-----------------------------------ooo--------------------------------------------ooo-----------------------------------------------f
-------ooo--B-B-------------------M-M-B------------?-M-------------------------------------------------?-?----B-B--------------B-B-------------ooo----------?-?-------------B-B-?----------------------f
---------------B-B-----------------?---ooo------------?-?------------------B-B-ooo-B------M-----X--X--------------------M-M-------?--------------------------?------------B-B----------------?-?-------f
----------------------------------------M-B----------------------B-B-------M----X-X-------------XXX---------M-M--------?-?M-------------------------------ooo-B-------B-B------------M--B-Boo----?-----f
---------?-?---------Boo-------------B-B-------------------?-?-?-----oooM-------XX------------T-XXX--B-------------------XX-----------------?-----------M-M---------------------------M-----------ooo--f
-oo--------------------------ooo----------------------------------------------T-XXX-----------|-XXXX---------------------XXooo----ooo------------------------------------------------------------------f
m-------E------E----------E---------------E------------------------------E----|XXXXX----------|XXXXXX---E---------------XXXX--------T--------------------E-----------------E--------E------E------------
XXXXXXXXXXXXXXXXXXXXXXXXXXXXXXXXXXXXXXXXXXXXXXXXXXXXXXXXXXXXXXXXXXXXXXXXXXXXXX|XXXXXXXXXXXXXXX|XXXXXXXXXXXXXXXXXXXXXXXXXXXXXXXXXXXXX|XXXXXXXXXXXXXXXXXXXXXXXXXXXXXXXXXXXXXXXXXXXXXXXXXXXXXXXXXXXXXXXXXXX
