--------------------------------------------------------------------------------------------------------------------------------------------------------------------------------------------------------
--------------------------------------------------------------------------------------------------------------------------------------------------------------------------------------------------------
--------------------------------------------------------------------------------------------------------------------------------------------------------------------------------------------------------
--------------------------------------------------------------------------------------------------------------------------------------------------------------------------------------------------------
--------------------------------------------------------------------------------------------------------------------------------------------------------------------------------------------------------
--------------------------------------------------------------------------------------------------------------------------------------------------------------------------------------------------------
--B-------B-B----M----------?--B-B--------------------M-M----------?----B--?-----------------ooo-B------ooo-----?------M?-?----------M-M------------M---------------------------------------------B-B--o
----------M---------M-M-?------------------------------------------------------M-M----------------------------------ooo-------ooooo-----------?-?----?-------------------------------------------------v
--------------------------?-------------------ooo-----?-------?-?oo----------M---?-?--------------------M-M--------------M-M---M-M?o?-------------------------?-?-----B--------?-?---------------------f
-B--------------------B-B--------------------------M-M----------------------------------ooo----------?---------------------------------------------------oooooo-ooo------------B-B--------------ooo----f
---------B-BM-M---------------M-M-----M-M-----ooo----------M-M---------------M--------------------------------?-?---ooo---------------------?ooo-------------------X--X--------------------------------f
------T-----------------------------------ooo--M-B------?-?-B--M-------T--M-----B---------M-ooo------ooo-------------------------------------------M-M-------------XXX-ooo------ooo------?-?-ooo-?-----f
-----B|---------------------------------T-B-B------------XX------------|-----------ooo-------?-?--M---------------------------------------M-M?-?---------M-Mooo----XXX------------------B----ooo----M-Mf
------|ooo----------T---------ooo-------|----------------XX------------|--------------------------------------------ooo--------------ooo----------------ooo--------XXXX-----------T--------------------f
m-----|----------E--|-------------------|---E----E------XXXX-----------|---------------------------------------------E--------------E--------E----------------EE--XXXXXX----------|--------------------X
XXXXXXXXXXXXXXXXXXXXXXXXXXXXXXXXXXXXXXXXXXXXXXXXXXXXXXXXXXXXXXXXXXXXXXXXXXXXXXXXXXXXXXXXXXXXXXXXXXXXXXXXXXXXXXXXXXXXXXXXXXXXXXXXXXXXXXXXXXXXXXXXXXXXXXXXXXXXXXXXXXXXXXXXXXXXXXXXXXXXXXXXXXXXXXXXXXXXXXXX
