--------------------------------------------------------------------------------------------------------------------------------------------------------------------------------------------------------
--------------------------------------------------------------------------------------------------------------------------------------------------------------------------------------------------------
--------------------------------------------------------------------------------------------------------------------------------------------------------------------------------------------------------
--------------------------------------------------------------------------------------------------------------------------------------------------------------------------------------------------------
--------------------------------------------------------------------------------------------------------------------------------------------------------------------------------------------------------
--------------------------------------------------------------------------------------------------------------------------------------------------------------------------------------------------------
--------?-----------------------------------------?B-B-?--------ooo----?-?----------------------?------------M-M---------------?-?----------------------------------------------------------------------
-----------------------------------M-M------------ooo------------------------------------------------B-B-B----------------------ooo----------------B--?-?----?-?---------?-?-----ooo-------------------v
------------------------?-?------------------M-M----------------M-M-----------------------------------ooo--------------------------------------------ooo--------?-------------------------ooo----------f
-------ooo--B-------------------------B----------ooo--B-B---------------ooo-----------------M-M--------?-?--ooB-B?-----------------------------ooo--------------------------B-B----------------------B-f
---------B-B---B-B---------------------ooo------------?-?------------------B-------B------M-M---X--X--------M-----------M-M-------?-----M--------------------------------------------------------------f
----------------------------------------M-B-------------?--------B-B------------X-Xooo----------XXX-----------M--------?-?M-------------------------------ooo-B-BM----------------------B-Boo-B-------Bf
---------?-?---------B-------------------------------------?-?-?----------------XX------------T-XXX--B-------------------XX-----------------?------------------M---M-M-?-?----------M-------------ooo--f
-oo--------------------------ooo----------------------------------------------T-XXX-----------|-XXXX---------------------XXooo----ooo------------------------------------------------------------------f
m-------E------E----------E---------------E------------------------------E----|XXXXX----------|XXXXXX---E---------------XXXX--------T--------------------E-----------------E--------E------E------------
XXXXXXXXXXXXXXXXXXXXXXXXXXXXXXXXXXXXXXXXXXXXXXXXXXXXXXXXXXXXXXXXXXXXXXXXXXXXXX|XXXXXXXXXXXXXXX|XXXXXXXXXXXXXXXXXXXXXXXXXXXXXXXXXXXXX|XXXXXXXXXXXXXXXXXXXXXXXXXXXXXXXXXXXXXXXXXXXXXXXXXXXXXXXXXXXXXXXXXXX
