--------------------------------------------------------------------------------------------------------------------------------------------------------------------------------------------------------
--------------------------------------------------------------------------------------------------------------------------------------------------------------------------------------------------------
--------------------------------------------------------------------------------------------------------------------------------------------------------------------------------------------------------
--------------------------------------------------------------------------------------------------------------------------------------------------------------------------------------------------------
--------------------------------------------------------------------------------------------------------------------------------------------------------------------------------------------------------
--------------------------------------------------------------------------------------------------------------------------------------------------------------------------------------------------------
--------?------------B----------------------------?B-B-----------------?-?----------------------?-----------------------------------------------------------------------------------?-?-----------------
--------------------------------------------------ooo------------------------M--B--?--------------M-MB-B-B-------?-?------------ooo----------------B--?-?B-B-------------?-?-----ooo-------------------v
------------------------?-?---B--------------M-M----------------M-M----------------------------M-M----ooo--------------------------------------------ooo-----------------------------------------------f
-------ooo--B-B-----------------------B--------------------M-M-----------------------------------------?-?------B------------------------------ooo-------------------?-?----B-B--------------------M-M-f
---------------B-B---------------------ooo----ooo-----?-?--ooo-------------B-B-----B--M---M-----X--X--------------------M-M-------?---------------------?-?--------------------------------------------f
----------------------------------------M-B-----------ooo--------B-B-------M----X-X-------------XXX---------M-M--------?-?--------------------------------ooo---B-------?---------------B-Boo----------f
---------?-?---------B-------------------------------------?-?-?-----B-B----B---XX------------T-XXX--B-------------------XX-----------ooo---?-------------------ooo-----------------M-M---------M-ooo--f
-oo--------------------------ooo----------------------------------------------T-XXX-----------|-XXXX---------------------XXooo----ooo-----------ooo----------------------------------------------------f
m-------E------E----------E---------------E------------------------------E----|XXXXX----------|XXXXXX---E---------------XXXX--------T--------------------E-----------------E--------E------E------------
XXXXXXXXXXXXXXXXXXXXXXXXXXXXXXXXXXXXXXXXXXXXXXXXXXXXXXXXXXXXXXXXXXXXXXXXXXXXXX|XXXXXXXXXXXXXXX|XXXXXXXXXXXXXXXXXXXXXXXXXXXXXXXXXXXXX|XXXXXXXXXXXXXXXXXXXXXXXXXXXXXXXXXXXXXXXXXXXXXXXXXXXXXXXXXXXXXXXXXXX
