--------------------------------------------------------------------------------------------------------------------------------------------------------------------------------------------------------
--------------------------------------------------------------------------------------------------------------------------------------------------------------------------------------------------------
--------------------------------------------------------------------------------------------------------------------------------------------------------------------------------------------------------
--------------------------------------------------------------------------------------------------------------------------------------------------------------------------------------------------------
--------------------------------------------------------------------------------------------------------------------------------------------------------------------------------------------------------
--------------------------------------------------------------------------------------------------------------------------------------------------------------------------------------------------------
------?-?-----------------------------------------?B-B-----------------?-?-----------B-B--------?---M-M-----------------------------?-?---------B-----------------------------------------B-B-----------
--------------------------------------------------ooo-----------------------ooo------------B-BB------B-B-B----------------------ooo-------------------?-?----------------?-?-----ooo----?-?------------v
------------------------?-?------------------M-M----------------M-M----M------------------------B-B---ooo-ooo----------------------------------------ooo--------------B-B-?----------------------------f
-------ooo--B-B-----------------------B---------------?-?----------------------------------------------?-?----B-B----------------ooo-----------ooo---------ooo--------------B-B------------------------f
------B--------B-B---------------------ooo------------?-?------------------B-B--?-?B------M-M---X--X------ooo--M-M------M-M-------?----M-M-------B-B---------------------------------------------------f
----------------------------ooo---------M-B----------------------B-B-------M----X-X-------------XXX---------M-M--------?-?M-------------------------------ooo-B-B-----------------------B-Boo----?-----f
-----------?---------B-------------------------------------?-?-?----------------XX------------T-XXX--B---------------ooo-XX-----------------?---------------------------------------M-M-----------ooo--f
-oo--------------------------ooooo-----------ooo-------------ooo--------------T-XXX-----------|-XXXX---------------------XXooo----ooo------------------------------------------------------------------f
m-------E------E----------E---------------E------------------------------E----|XXXXX----------|XXXXXX---E---------------XXXX--------T--------------------E-----------------E--------E------E------------
XXXXXXXXXXXXXXXXXXXXXXXXXXXXXXXXXXXXXXXXXXXXXXXXXXXXXXXXXXXXXXXXXXXXXXXXXXXXXX|XXXXXXXXXXXXXXX|XXXXXXXXXXXXXXXXXXXXXXXXXXXXXXXXXXXXX|XXXXXXXXXXXXXXXXXXXXXXXXXXXXXXXXXXXXXXXXXXXXXXXXXXXXXXXXXXXXXXXXXXX
