--------------------------------------------------------------------------------------------------------------------------------------------------------------------------------------------------------
--------------------------------------------------------------------------------------------------------------------------------------------------------------------------------------------------------
--------------------------------------------------------------------------------------------------------------------------------------------------------------------------------------------------------
--------------------------------------------------------------------------------------------------------------------------------------------------------------------------------------------------------
--------------------------------------------------------------------------------------------------------------------------------------------------------------------------------------------------------
--------------------------------------------------------------------------------------------------------------------------------------------------------------------------------------------------------
--M---?---------------------------?---------------?B-B-----------------?-?----------------------?---------------------ooo------B-B---------B-B---------B-B----------------------------------------------
--------------------------------------------------ooo------------------------------------------------B-B-B----------------------ooo----------------B--?-?----------------?-------ooo-------------------v
------------------------?-?------------------M-M----ooo---------M-M-----------------------------------ooo--------------------------------------------ooo---?-?-----------------------------------------f
-------ooo--B-B-----------------------B--------------------ooo-----------ooo--------M------------------?-?----B-B-------ooo--M-----------------ooo--------------------------B-B-----------------M-M----f
---------------B-B---?-?---------------ooo------------?-?------------------B-B-----B------M-M---X--X--------------------M-M-------?---------------------------------?-?--------------------------------f
----------------------------------------M-B--------------------M-B-B-------M----X-X-------------XXX---------M-M--------?-?M---ooo----------ooo------------ooooB-B-------------------------Boo----------f
---------?-----------B-------------------------------------?-?-?----------------XX------------T-XXX--B-------------------XX-----------------?---------------------------------------M-M-----------ooo--f
-oo-------------ooo----------ooo----------------------------------------------T-XXX-----------|-XXXX---------------------XXooo----ooo------------------------------------------------------------------f
m-------E------E----------E---------------E------------------------------E----|XXXXX----------|XXXXXX---E---------------XXXX--------T--------------------E-----------------E--------E------E------------
XXXXXXXXXXXXXXXXXXXXXXXXXXXXXXXXXXXXXXXXXXXXXXXXXXXXXXXXXXXXXXXXXXXXXXXXXXXXXX|XXXXXXXXXXXXXXX|XXXXXXXXXXXXXXXXXXXXXXXXXXXXXXXXXXXXX|XXXXXXXXXXXXXXXXXXXXXXXXXXXXXXXXXXXXXXXXXXXXXXXXXXXXXXXXXXXXXXXXXXX
