--------------------------------------------------------------------------------------------------------------------------------------------------------------------------------------------------------
--------------------------------------------------------------------------------------------------------------------------------------------------------------------------------------------------------
--------------------------------------------------------------------------------------------------------------------------------------------------------------------------------------------------------
--------------------------------------------------------------------------------------------------------------------------------------------------------------------------------------------------------
--------------------------------------------------------------------------------------------------------------------------------------------------------------------------------------------------------
--------------------------------------------------------------------------------------------------------------------------------------------------------------------------------------------------------
--------------------------------------------------------------------------------------------------------------------------------------------------------------------------------------------------------
-------------------------------------------------------------------------------------------------------------------------------------------------------------------------------------------------------v
-------------------------------------------------------------------------------------------------------------------------------------------------------------------------------------------------------f
-------------B------------B-------------------B-B---B-B-----B-B-------------------B-----------------------------------ooo--?-?----ooo-------------?-?ooo-----------M-M--------?-?----------ooo---------f
M----------------------------------------MB-----ooo-----------------------------ooo----------M--?-?----?----------ooo------------B----------------------------ooo----ooo------ooo-B-B------------------f
---------------------------ooo-----ooo----B-B----------------------?-?---------ooo-B-B-------?-----ooo------------------------------------------?-?-----B---------ooo---ooo----------------------------f
----------------?-----------X---T-------T-----------ooo--------ooo---------?-?-------------------T------------------B-B-------?X-ooo----ooo-----------------M------------------------------------------f
---------------------------XXX--|-------|-------------ooo------X---------T-------X---------------|----------------------------XXX------------------------------------------T------------X--------------f
m----------E--------------XXXXX-|-------|---------------E-----XXX-E------|------XXX-------------E|---------E-----------------XXXXX------E--E--E-E------------------T--E----|-----------XXX--------E----X
XXXXXXXXXXXXXXXXXXXXXXXXXXXXXXXX|XXXXXXX|XXXXXXXXXXXXXXXXXXXXXXXXXXXXXXXX|XXXXXXXXXXXXXXXXXXXXXXXXXXXXXXXXXXXXXXXXXXXXXXXXXXXXXXXXXXXXXXXXXXXXXXXXXXXXXXXXXXXXXXXXXXXXXXXXXXXXXXXXXXXXXXXXXXXXXXXXXXXXXX
