--------------------------------------------------------------------------------------------------------------------------------------------------------------------------------------------------------
--------------------------------------------------------------------------------------------------------------------------------------------------------------------------------------------------------
--------------------------------------------------------------------------------------------------------------------------------------------------------------------------------------------------------
--------------------------------------------------------------------------------------------------------------------------------------------------------------------------------------------------------
--------------------------------------------------------------------------------------------------------------------------------------------------------------------------------------------------------
--------------------------------------------------------------------------------------------------------------------------------------------------------------------------------------------------------
--------------------------------------------------------------------------------------------------------------------------------------------------------------------------------------------------------
-------------------------------------------------------------------------------------------------------------------------------------------------------------------------------------------------------v
-------------------------------------------------------------------------------------------------------------------------------------------------------------------------------------------------------f
--------------------------B-B---------B-B-------------------B-B----------------?-?------------------------------------ooo--?-?-----------------------ooo-B---------M-M--------?--------?-?-ooo---------f
M----------------------------------------M-------------------------------------------------M-M-------?-?-------------------------B--M-M--?-?------------------ooo----ooo------ooo-B-B------------------f
-------B--------?-?--------ooo------------B-B----------------------------------ooo-B-B-------?-----ooo--------------------------------------------------B---------ooo---ooo--------------------------B-f
----------------------------X---T-------T-----------ooo--------ooo---ooo--ooo--M-----------------T------B---------------------?X-ooo------------------------M--------------------------ooo-------------f
---------------------------XXX--|-------|-------------ooo------X---------T-------X---------------|----------------------------XXX------------------------------------------T------------X--------------f
m----------E--------------XXXXX-|-------|---------------E-----XXX-E------|------XXX-------------E|---------E-----------------XXXXX------E--E--E-E------------------T--E----|-----------XXX--------E----X
XXXXXXXXXXXXXXXXXXXXXXXXXXXXXXXX|XXXXXXX|XXXXXXXXXXXXXXXXXXXXXXXXXXXXXXXX|XXXXXXXXXXXXXXXXXXXXXXXXXXXXXXXXXXXXXXXXXXXXXXXXXXXXXXXXXXXXXXXXXXXXXXXXXXXXXXXXXXXXXXXXXXXXXXXXXXXXXXXXXXXXXXXXXXXXXXXXXXXXXX
