--------------------------------------------------------------------------------------------------------------------------------------------------------------------------------------------------------
--------------------------------------------------------------------------------------------------------------------------------------------------------------------------------------------------------
--------------------------------------------------------------------------------------------------------------------------------------------------------------------------------------------------------
--------------------------------------------------------------------------------------------------------------------------------------------------------------------------------------------------------
--------------------------------------------------------------------------------------------------------------------------------------------------------------------------------------------------------
--------------------------------------------------------------------------------------------------------------------------------------------------------------------------------------------------------
------?----------------M-M------------------------?B-B-----------------?-?----------------------?----------?-?------------------------B-B-----------------------------------------------------------?-?-
-----B-B------------------------------------------ooo------------------------------------------------B-B-B----------------M-M---ooo--------ooo-----B--?-?----------?-?---?-------ooo-------ooo---------v
------------ooo---------?-?------------------M-M----------------M-M-------------------------?---------ooo----------------------------ooo-------------ooo---M-------------------------------------------f
--ooo--ooo--B-B----------ooo----------B----------------M---------------?-?-----ooo---------------------?-?----B------ooo-----------------------ooo--------------------------B-B--------------?-?-------f
---------------B-B---------------------ooo------------?-?------------------B-B-----B------M-M---X--X--------------------M-M-------?--------------------------------------------------------------------f
------------------B---------------------M-B----------------------B-B---B-B-M----X-X-------------XXX---------M-M--------?-?M--------------------B-B--------ooo-B-B-------ooo-------------B-Boo--?-------f
---------?-?---------B------------M-M----------------------?-?-?----------ooo---XX------------T-XXX----?-?---------M-M---XX-----------------?---------------------------------------M-M-----------ooo--f
-oo--------------------------ooo----------------------------------------------T-XXX-----------|-XXXX---------------------XXooo----ooo------------------------------------------------------------------f
m-------E------E----------E---------------E------------------------------E----|XXXXX----------|XXXXXX---E---------------XXXX--------T--------------------E-----------------E--------E------E------------
XXXXXXXXXXXXXXXXXXXXXXXXXXXXXXXXXXXXXXXXXXXXXXXXXXXXXXXXXXXXXXXXXXXXXXXXXXXXXX|XXXXXXXXXXXXXXX|XXXXXXXXXXXXXXXXXXXXXXXXXXXXXXXXXXXXX|XXXXXXXXXXXXXXXXXXXXXXXXXXXXXXXXXXXXXXXXXXXXXXXXXXXXXXXXXXXXXXXXXXX
