--------------------------------------------------------------------------------------------------------------------------------------------------------------------------------------------------------
--------------------------------------------------------------------------------------------------------------------------------------------------------------------------------------------------------
--------------------------------------------------------------------------------------------------------------------------------------------------------------------------------------------------------
--------------------------------------------------------------------------------------------------------------------------------------------------------------------------------------------------------
--------------------------------------------------------------------------------------------------------------------------------------------------------------------------------------------------------
--------------------------------------------------------------------------------------------------------------------------------------------------------------------------------------------------------
-B-Booo----M---------------M-M---------------M-M--B---------------------------------------------------------?-----B-B------------------------ooo-M----------B-B--?-?M-M--------------------?-?----------
----ooo-ooo-----------------?-?---------------B-B------------M-----------?-?-----B-B----------B-B--------ooo-----------------------?-?--------------ooo-ooo---------------ooo--------ooo----ooo--------v
----------M-M---------------------ooo---------------------------------------?--------------B-B-----------------ooo-----------------ooo-------------------------------M------------?-?------------------f
---------------------------------B----------B-B----BB-B-------------ooo-B----------------------------ooo-------B-B?-?--ooo-----------------ooo--------B-BB-B-B-----------------------------------------f
------BBB--------------M-M--B---------B----ooo-----------------------------------------B------------------------------------------M----------------------------------------M-M-------------------------f
------------M-------------------ooo--------------------M---------------------XMX----------------------------------B-M-M---------------?----------------------------------------------------------------f
------M---?-?--------------------------------------------B-B-------M---?-?---XX-------M-M----------------XX----------------------------?-?---?-?-?---------------------------?-?-----------------------f
-oo--------------------------------------------------------------------------XXX-------------------------XXoo-----------------------------------------------------------ooo----------------------------f
m-------------------------T----------------E----------E---------------------XXXXX----------------E--E---XXXX-----------E-----T-----E-E-------T-E----E----------E-T-----------------------------------E--
XXXXXXXXXXXXXXXXXXXXXXXXXX|XXXXXXXXXXXXXXXXXXXXXXXXXXXXXXXXXXXXXXXXXXXXXXXXXXXXXXXXXXXXXXXXXXXXXXXXXXXXXXXXXXXXXXXXXXXXXXXXXX|XXXXXXXXXXXXXXX|XXXXXXXXXXXXXXXXXXX|XXXXXXXXXXXXXXXXXXXXXXXXXXXXXXXXXXXXXX
