--------------------------------------------------------------------------------------------------------------------------------------------------------------------------------------------------------
--------------------------------------------------------------------------------------------------------------------------------------------------------------------------------------------------------
--------------------------------------------------------------------------------------------------------------------------------------------------------------------------------------------------------
--------------------------------------------------------------------------------------------------------------------------------------------------------------------------------------------------------
--------------------------------------------------------------------------------------------------------------------------------------------------------------------------------------------------------
--------------------------------------------------------------------------------------------------------------------------------------------------------------------------------------------------------
--------------------------------------------------------------------------------------------------------------------------------------------------------------------------------------------------------
-------------------------------------------------------------------------------------------------------------------------------------------------------------------------------------------------------v
-------------------------------------------------------------------------------------------------------------------------------------------------------------------------------------------------------f
ooo------B-B-----ooo--------B------ooo-M-M-----------------ooM-M---B-B--B-B---------------------------------------?-B------------B--------?-----------B-BM-M---M-M-------------------M-M----B-B--------f
--M----M-B-B-B-------ooo---------B-B-?------B----M-Mooo-?-?------------------------------?-??------------B-------------B---ooo------------------------M--------?---------------------?-?-B-B-----------f
----------------M-M--M-M----------------M-M-M-M-----B------------ooo-M-M--------M-M--ooo------------------------?--------------M-----------M-M---------------BB--------------------------ooo---------oof
----?-T------------------T-------------T-?--?--------?----B-B-X-----B-B-B-------?-?--?--Boo----------------Mooo--M-M--------?-?-----M--B------ooo---M----------ooo--------------B----------------------f
------|--------ooo-----oo|-------------|-----------------T---XXX---------X----------------------------------------------ooo--------T-------ooo------------------ooo-------------------------X----------f
m-----|-------------E----|-------------|------------T----|E-XXXXX-------XXX--------------------E--------------E-----------E-E------|-------------------------------------------------------XXX---------X
XXXXXX|XXXXXXXXXXXXXXXXXX|XXXXXXXXXXXXX|XXXXXXXXXXXX|XXXX|XXXXXXXXXXXXXXXXXXXXXXXXXXXXXXXXXXXXXXXXXXXXXXXXXXXXXXXXXXXXXXXXXXXXXXXXX|XXXXXXXXXXXXXXXXXXXXXXXXXXXXXXXXXXXXXXXXXXXXXXXXXXXXXXXXXXXXXXXXXXXX
