--------------------------------------------------------------------------------------------------------------------------------------------------------------------------------------------------------
--------------------------------------------------------------------------------------------------------------------------------------------------------------------------------------------------------
--------------------------------------------------------------------------------------------------------------------------------------------------------------------------------------------------------
--------------------------------------------------------------------------------------------------------------------------------------------------------------------------------------------------------
--------------------------------------------------------------------------------------------------------------------------------------------------------------------------------------------------------
--------------------------------------------------------------------------------------------------------------------------------------------------------------------------------------------------------
--------------------------------------------------------------------------------------------------------------------------------------------------------------------------------------------------------
-------------------------------------------------------------------------------------------------------------------------------------------------------------------------------------------------------v
-------------------------------------------------------------------------------------------------------------------------------------------------------------------------------------------------------f
--------------?-?---------B-B-------------------------------B-B--ooo--------------------------------------------ooo---ooo--?-?-----------------------ooo--------?--M-M--------?------------ooo---------f
M-------------------------------ooooo----M--M-M----------------------B-B-------------------M-M---------?-------------------------B---------------------B-Boo--ooo----ooo------ooo-B-B------------------f
--------?-?----------------ooo--------------B----?-----------------------------ooo-B-B-------?-----ooo---------?----------------------------------------B---------oooB--ooo----------------------------f
----------------------------X---T-------T-----------ooo-----oooooo-------------------------------T-------------B--------------?X-ooo----------------------------------------------B--------------------f
---------------------------XXX--|-------|-------------ooo------X---------T-------X---------------|----------------------------XXX------------------------------------------T------------X--------------f
m----------E--------------XXXXX-|-------|---------------E-----XXX-E------|------XXX-------------E|---------E-----------------XXXXX------E--E--E-E------------------T--E----|-----------XXX--------E----X
XXXXXXXXXXXXXXXXXXXXXXXXXXXXXXXX|XXXXXXX|XXXXXXXXXXXXXXXXXXXXXXXXXXXXXXXX|XXXXXXXXXXXXXXXXXXXXXXXXXXXXXXXXXXXXXXXXXXXXXXXXXXXXXXXXXXXXXXXXXXXXXXXXXXXXXXXXXXXXXXXXXXXXXXXXXXXXXXXXXXXXXXXXXXXXXXXXXXXXXX
