--------------------------------------------------------------------------------------------------------------------------------------------------------------------------------------------------------
--------------------------------------------------------------------------------------------------------------------------------------------------------------------------------------------------------
--------------------------------------------------------------------------------------------------------------------------------------------------------------------------------------------------------
--------------------------------------------------------------------------------------------------------------------------------------------------------------------------------------------------------
--------------------------------------------------------------------------------------------------------------------------------------------------------------------------------------------------------
--------------------------------------------------------------------------------------------------------------------------------------------------------------------------------------------------------
--------------------------------------------------------------------------------------------------------------------------------------------------------------------------------------------------------
-------------------------------------------------------------------------------------------------------------------------------------------------------------------------------------------------------v
-------------------------------------------------------------------------------------------------------------------------------------------------------------------------------------------------------f
---------------------------------------------?-?------------------------B---------B---------B-B---------------ooo--------------------------M-----------------ooo---------------------------------------f
---------?-?---?-?-o------------------------------------------------?-?------?o--ooo----------------------------------B---------o------------------ooo---------------------------B---------------------f
--ooo---------------B-o-o------------------ooo---B-B----------------------------------B-----------T-M-------------B-B---------X----------B--------X---------------------------------------------XB-----f
----------------------------X----------B-B--B-B----------------------?---------------------X------|----------T--------ooo----XXX-----------------XXoo-------------------------?----------ooo---XXX-----f
ooo-----------ooo----------XXX------------------------------------------------------------XXX-----|----------|--------------XXXXX--oo-----------XXXXX----ooo-------ooo--------------------X---XXX-X----f
m-------------------------XXXXX-----------------------E---------E-----------------T---E--XXXXX----|---E------|-------------XXXXXXX-------------X-XXXXX------T----------------------------XXX-XX-X-XX---X
XXXXXXXXXXXXXXXXXXXXXXXXXXXXXXXXXXXXXXXXXXXXXXXXXXXXXXXXXXXXXXXXXXXXXXXXXXXXXXXXXXXXXXXXXXXXXXXXXXXXXXXXXXXXXXXXXXXXXXXXXXXXXXXXXXXXXXXXXXXXXXXXXXXXXXXXXXXXXXXXXXXXXXXXXXXXXXXXXXXXXXXXXXXXXXXXXXXXXXXX
